//MAP CONVERTED BY dmm2tgm.py THIS HEADER COMMENT PREVENTS RECONVERSION, DO NOT REMOVE
"a" = (
/obj/effect/turf_decal/tile/neutral/tram,
/obj/effect/landmark/transport/transport_id/tramstation/line_1,
/obj/structure/transport/linear/tram,
/obj/structure/thermoplastic/light,
/turf/open/floor/iron,
/area/awaymission/centcom_away)
"b" = (
/obj/structure/transport/linear/tram/corner/northeast,
/obj/structure/tram/spoiler{
	dir = 1
	},
/turf/open/floor/iron,
/area/awaymission/centcom_away)
"d" = (
/obj/structure/fluff/tram_rail/electric/anchor,
/obj/structure/transport/linear/tram,
/obj/structure/thermoplastic,
/obj/structure/chair/sofa/bench/tram,
/turf/open/floor/iron,
/area/awaymission/centcom_away)
"f" = (
/obj/structure/transport/linear/tram,
/obj/structure/tram/split,
/obj/machinery/transport/destination_sign/split/south,
/turf/open/floor/iron,
/area/awaymission/centcom_away)
"g" = (
/obj/structure/fluff/tram_rail/electric,
/obj/structure/transport/linear/tram,
/obj/structure/tram,
/turf/open/floor/iron,
/area/awaymission/centcom_away)
"h" = (
/obj/structure/fluff/tram_rail/electric,
/obj/structure/transport/linear/tram,
/obj/structure/thermoplastic,
/obj/structure/chair/sofa/bench/tram/left,
/obj/machinery/computer/tram_controls/split/directional/north,
/turf/open/floor/iron,
/area/awaymission/centcom_away)
"k" = (
/obj/structure/fluff/tram_rail/electric{
	dir = 1
	},
/obj/structure/transport/linear/tram,
/obj/structure/thermoplastic,
/obj/structure/chair/sofa/bench/tram/right{
	dir = 1
	},
/turf/open/floor/iron,
/area/awaymission/centcom_away)
"l" = (
/obj/structure/transport/linear/tram,
/obj/structure/thermoplastic/light,
/turf/open/floor/iron,
/area/awaymission/centcom_away)
"n" = (
/obj/structure/fluff/tram_rail/electric,
/obj/structure/transport/linear/tram,
/obj/structure/thermoplastic/light,
/turf/open/floor/iron,
/area/awaymission/centcom_away)
"o" = (
/obj/structure/fluff/tram_rail/electric,
/obj/structure/transport/linear/tram,
/obj/structure/thermoplastic,
/turf/open/floor/iron,
/area/awaymission/centcom_away)
"p" = (
/obj/structure/fluff/tram_rail/electric{
	dir = 1
	},
/obj/structure/transport/linear/tram,
/obj/structure/thermoplastic,
/obj/structure/chair/sofa/bench/tram/left{
	dir = 1
	},
/obj/machinery/computer/tram_controls/split/directional/south,
/turf/open/floor/iron,
/area/awaymission/centcom_away)
"q" = (
/obj/structure/transport/linear/tram,
/obj/structure/tram,
/obj/machinery/transport/tram_controller,
/turf/open/floor/iron,
/area/awaymission/centcom_away)
"r" = (
/obj/effect/turf_decal/tile/neutral/tram,
/obj/structure/transport/linear/tram,
/obj/structure/thermoplastic,
/obj/structure/chair/sofa/bench/tram/left{
	dir = 4
	},
/turf/open/floor/iron,
/area/awaymission/centcom_away)
"s" = (
/obj/structure/fluff/tram_rail/electric/anchor{
	dir = 1
	},
/obj/structure/transport/linear/tram,
/obj/structure/thermoplastic,
/obj/structure/chair/sofa/bench/tram{
	dir = 1
	},
/turf/open/floor/iron,
/area/awaymission/centcom_away)
"v" = (
/obj/structure/fluff/tram_rail/electric{
	dir = 1
	},
/obj/structure/transport/linear/tram,
/obj/structure/thermoplastic,
/obj/structure/chair/sofa/bench/tram/right{
	dir = 4
	},
/turf/open/floor/iron,
/area/awaymission/centcom_away)
"w" = (
/obj/effect/turf_decal/tile/neutral/tram,
/obj/structure/transport/linear/tram,
/obj/structure/thermoplastic/light,
/turf/open/floor/iron,
/area/awaymission/centcom_away)
"z" = (
/obj/structure/transport/linear/tram/corner/southeast,
/obj/structure/tram/spoiler{
	dir = 4
	},
/turf/open/floor/iron,
/area/awaymission/centcom_away)
"B" = (
/obj/structure/fluff/tram_rail,
/obj/structure/transport/linear/tram,
/obj/structure/thermoplastic/light,
/turf/open/floor/iron,
/area/awaymission/centcom_away)
"C" = (
/obj/structure/fluff/tram_rail/electric{
	dir = 1
	},
/obj/structure/transport/linear/tram,
/obj/structure/tram,
/turf/open/floor/iron,
/area/awaymission/centcom_away)
"E" = (
/obj/effect/turf_decal/tile/neutral/tram,
/obj/structure/transport/linear/tram,
/obj/structure/thermoplastic,
/obj/structure/chair/sofa/bench/tram/left{
	dir = 8
	},
/turf/open/floor/iron,
/area/awaymission/centcom_away)
"H" = (
/obj/structure/transport/linear/tram,
/obj/structure/thermoplastic/light,
/obj/machinery/door/airlock/tram,
/turf/open/floor/iron,
/area/awaymission/centcom_away)
"I" = (
/obj/structure/transport/linear/tram/corner/southwest,
/obj/structure/tram/spoiler,
/turf/open/floor/iron,
/area/awaymission/centcom_away)
"J" = (
/obj/effect/turf_decal/tile/neutral/tram,
/obj/structure/transport/linear/tram,
/obj/structure/thermoplastic/light,
/obj/effect/landmark/transport/nav_beacon/tram/nav/tramstation/main,
/turf/open/floor/iron,
/area/awaymission/centcom_away)
"K" = (
/obj/effect/landmark/start/hangover,
/obj/effect/turf_decal/tile/neutral/tram,
/obj/structure/transport/linear/tram,
/obj/structure/thermoplastic/light,
/turf/open/floor/iron,
/area/awaymission/centcom_away)
"N" = (
/obj/effect/turf_decal/tile/neutral/tram,
/obj/structure/transport/linear/tram,
/obj/structure/tram,
/turf/open/floor/iron,
/area/awaymission/centcom_away)
"P" = (
/obj/structure/fluff/tram_rail/electric{
	dir = 1
	},
/obj/structure/transport/linear/tram,
/obj/structure/thermoplastic,
/turf/open/floor/iron,
/area/awaymission/centcom_away)
"Q" = (
/obj/structure/fluff/tram_rail/electric,
/obj/structure/transport/linear/tram,
/obj/structure/thermoplastic,
/obj/structure/chair/sofa/bench/tram/right,
/turf/open/floor/iron,
/area/awaymission/centcom_away)
"R" = (
/obj/structure/fluff/tram_rail/electric{
	dir = 1
	},
/obj/structure/transport/linear/tram,
/obj/structure/thermoplastic/light,
/turf/open/floor/iron,
/area/awaymission/centcom_away)
"S" = (
/obj/structure/transport/linear/tram/corner/northwest,
/obj/structure/tram/spoiler{
	dir = 8
	},
/turf/open/floor/iron,
/area/awaymission/centcom_away)
"T" = (
/obj/structure/transport/linear/tram,
/obj/structure/tram/split,
/turf/open/floor/iron,
/area/awaymission/centcom_away)
"U" = (
/obj/structure/fluff/tram_rail/electric,
/obj/structure/transport/linear/tram,
/obj/structure/thermoplastic,
/obj/structure/chair/sofa/bench/tram/right{
	dir = 8
	},
/turf/open/floor/iron,
/area/awaymission/centcom_away)
"W" = (
/obj/structure/transport/linear/tram,
/obj/structure/tram/split,
/obj/machinery/transport/destination_sign/split/north,
/turf/open/floor/iron,
/area/awaymission/centcom_away)
"X" = (
/obj/structure/transport/linear/tram,
/obj/structure/tram,
/turf/open/floor/iron,
/area/awaymission/centcom_away)
"Z" = (
/obj/structure/transport/linear/tram,
/obj/structure/tram,
/obj/structure/plaque/static_plaque/tram,
/turf/open/floor/iron,
/area/awaymission/centcom_away)

(1,1,1) = {"
S
g
N
C
I
"}
(2,1,1) = {"
q
o
r
v
X
"}
(3,1,1) = {"
H
n
w
R
H
"}
(4,1,1) = {"
l
n
K
R
l
"}
(5,1,1) = {"
T
Q
a
p
f
"}
(6,1,1) = {"
T
d
J
s
T
"}
(7,1,1) = {"
W
h
w
k
T
"}
(8,1,1) = {"
H
B
K
R
H
"}
(9,1,1) = {"
l
n
w
R
l
"}
(10,1,1) = {"
X
U
E
P
Z
"}
(11,1,1) = {"
b
g
N
C
z
"}
