//MAP CONVERTED BY dmm2tgm.py THIS HEADER COMMENT PREVENTS RECONVERSION, DO NOT REMOVE
"a" = (
/turf/open/floor/glass,
/area/centcom/central_command_areas/evacuation)
"b" = (
/obj/structure/fluff/tram_rail/electric,
/obj/structure/transport/linear/tram,
/obj/structure/thermoplastic,
/turf/open/floor/mineral/gold,
/area/centcom/central_command_areas/evacuation)
"f" = (
/turf/open/floor/mineral/diamond,
/area/centcom/central_command_areas/evacuation)
"g" = (
/obj/structure/transport/linear/tram,
/obj/structure/thermoplastic/light,
/obj/machinery/door/airlock/tram,
/turf/open/floor/mineral/gold,
/area/centcom/central_command_areas/evacuation)
"l" = (
/obj/structure/fluff/tram_rail/electric{
	dir = 1
	},
/obj/structure/transport/linear/tram,
/obj/structure/tram,
/turf/open/floor/mineral/gold,
/area/centcom/central_command_areas/evacuation)
"p" = (
/obj/structure/transport/linear/tram,
/obj/structure/thermoplastic/light,
/turf/open/floor/mineral/gold,
/area/centcom/central_command_areas/evacuation)
"q" = (
/obj/structure/holosign/barrier/atmos/tram,
/turf/open/floor/glass,
/area/centcom/central_command_areas/evacuation)
"r" = (
/obj/structure/fluff/tram_rail/electric,
/obj/structure/transport/linear/tram,
/obj/structure/tram,
/turf/open/floor/mineral/gold,
/area/centcom/central_command_areas/evacuation)
"s" = (
/obj/structure/fluff/tram_rail/electric{
	dir = 1
	},
/obj/structure/transport/linear/tram,
/obj/structure/thermoplastic,
/obj/structure/chair/sofa/bench/tram/left{
	dir = 1
	},
/obj/machinery/computer/tram_controls/split/directional/south,
/turf/open/floor/mineral/gold,
/area/centcom/central_command_areas/evacuation)
"t" = (
/obj/structure/fluff/tram_rail/electric{
	dir = 1
	},
/obj/structure/transport/linear/tram,
/obj/structure/thermoplastic/light,
/turf/open/floor/mineral/gold,
/area/centcom/central_command_areas/evacuation)
"y" = (
/obj/structure/transport/linear/tram,
/obj/structure/tram,
/obj/machinery/transport/tram_controller,
/turf/open/floor/mineral/gold,
/area/centcom/central_command_areas/evacuation)
"z" = (
/obj/structure/fluff/tram_rail/electric,
/obj/structure/transport/linear/tram,
/obj/structure/thermoplastic/light,
/turf/open/floor/mineral/gold,
/area/centcom/central_command_areas/evacuation)
"A" = (
/obj/structure/fluff/tram_rail/electric{
	dir = 1
	},
/obj/structure/transport/linear/tram,
/obj/structure/thermoplastic,
/obj/structure/chair/sofa/bench/tram/right{
	dir = 4
	},
/turf/open/floor/mineral/gold,
/area/centcom/central_command_areas/evacuation)
"B" = (
/obj/structure/transport/linear/tram/corner/southeast,
/obj/structure/tram/spoiler{
	dir = 4
	},
/turf/open/floor/mineral/gold,
/area/centcom/central_command_areas/evacuation)
"D" = (
/obj/structure/fluff/tram_rail/electric,
/obj/structure/transport/linear/tram,
/obj/structure/thermoplastic,
/obj/structure/chair/sofa/bench/tram/right,
/turf/open/floor/mineral/gold,
/area/centcom/central_command_areas/evacuation)
"E" = (
/obj/structure/fluff/tram_rail/electric/anchor{
	dir = 1
	},
/obj/structure/transport/linear/tram,
/obj/structure/thermoplastic,
/obj/structure/chair/sofa/bench/tram{
	dir = 1
	},
/turf/open/floor/mineral/gold,
/area/centcom/central_command_areas/evacuation)
"F" = (
/obj/effect/turf_decal/tile/neutral/tram,
/obj/structure/transport/linear/tram,
/obj/structure/thermoplastic,
/obj/structure/chair/sofa/bench/tram/left{
	dir = 4
	},
/turf/open/floor/mineral/gold,
/area/centcom/central_command_areas/evacuation)
"G" = (
/turf/closed/indestructible/fakeglass,
/area/centcom/central_command_areas/evacuation)
"I" = (
/obj/structure/transport/linear/tram/corner/northwest,
/obj/structure/tram/spoiler{
	dir = 8
	},
/turf/open/floor/mineral/gold,
/area/centcom/central_command_areas/evacuation)
"J" = (
/obj/structure/transport/linear/tram,
/obj/structure/tram/split,
/turf/open/floor/mineral/gold,
/area/centcom/central_command_areas/evacuation)
"K" = (
/obj/structure/transport/linear/tram,
/obj/structure/tram,
/turf/open/floor/mineral/gold,
/area/centcom/central_command_areas/evacuation)
"L" = (
/obj/effect/turf_decal/tile/neutral/tram,
/obj/structure/transport/linear/tram,
/obj/structure/thermoplastic/light,
/turf/open/floor/mineral/gold,
/area/centcom/central_command_areas/evacuation)
"M" = (
/obj/structure/table/wood/fancy/royalblue,
/obj/effect/spawner/random/food_or_drink,
/turf/open/floor/glass,
/area/centcom/central_command_areas/evacuation)
"Q" = (
/obj/effect/turf_decal/tile/neutral/tram,
/obj/effect/landmark/transport/transport_id/tramstation/line_1,
/obj/structure/transport/linear/tram,
/obj/structure/thermoplastic/light,
/turf/open/floor/mineral/gold,
/area/centcom/central_command_areas/evacuation)
"S" = (
/obj/structure/fluff/tram_rail/electric/anchor,
/obj/structure/transport/linear/tram,
/obj/structure/thermoplastic,
/obj/structure/chair/sofa/bench/tram,
/turf/open/floor/mineral/gold,
/area/centcom/central_command_areas/evacuation)
"T" = (
/obj/structure/transport/linear/tram/corner/southwest,
/obj/structure/tram/spoiler,
/turf/open/floor/mineral/gold,
/area/centcom/central_command_areas/evacuation)
"U" = (
/turf/open/space/basic,
/area/space)
"W" = (
/obj/structure/transport/linear/tram,
/obj/structure/tram/split,
/obj/machinery/transport/destination_sign/split/south,
/turf/open/floor/mineral/gold,
/area/centcom/central_command_areas/evacuation)
"X" = (
/obj/effect/turf_decal/tile/neutral/tram,
/obj/structure/transport/linear/tram,
/obj/structure/tram,
/turf/open/floor/mineral/gold,
/area/centcom/central_command_areas/evacuation)
"Y" = (
/obj/structure/transport/linear/tram/corner/northeast,
/obj/structure/tram/spoiler{
	dir = 1
	},
/turf/open/floor/mineral/gold,
/area/centcom/central_command_areas/evacuation)
"Z" = (
/obj/effect/turf_decal/tile/neutral/tram,
/obj/structure/transport/linear/tram,
/obj/structure/thermoplastic/light,
/obj/effect/landmark/transport/nav_beacon/tram/nav/tramstation/main,
/obj/effect/landmark/transport/nav_beacon/tram/platform/tramstation/east,
/turf/open/floor/mineral/gold,
/area/centcom/central_command_areas/evacuation)

(1,1,1) = {"
U
G
G
G
G
G
G
G
q
q
q
q
q
G
G
G
G
G
G
G
"}
(2,1,1) = {"
U
G
a
a
a
a
a
a
a
a
a
a
a
a
a
a
a
a
a
G
"}
(3,1,1) = {"
U
G
a
a
a
a
a
a
a
a
a
a
a
a
a
a
a
a
a
G
"}
(4,1,1) = {"
U
G
a
a
a
a
a
a
a
a
a
a
a
a
a
a
a
a
a
G
"}
(5,1,1) = {"
U
G
a
a
a
a
a
a
a
a
a
a
a
a
a
a
a
a
a
G
"}
(6,1,1) = {"
U
G
a
a
a
a
a
a
a
a
a
a
a
a
a
a
a
a
a
G
"}
(7,1,1) = {"
U
G
a
a
a
a
a
f
f
f
f
f
f
f
a
a
a
a
M
G
"}
(8,1,1) = {"
U
G
a
a
a
a
a
f
I
r
X
l
T
f
a
a
a
a
M
G
"}
(9,1,1) = {"
U
G
a
a
a
a
a
f
y
b
F
A
K
f
a
a
a
a
M
G
"}
(10,1,1) = {"
U
G
a
a
a
a
a
f
g
z
L
t
K
f
a
a
a
a
M
G
"}
(11,1,1) = {"
U
G
a
a
a
a
a
f
p
z
Z
t
K
f
a
a
a
a
M
G
"}
(12,1,1) = {"
U
G
a
a
a
a
a
f
J
D
Q
s
W
f
a
a
a
a
M
G
"}
(13,1,1) = {"
U
G
a
a
a
a
a
f
J
S
L
E
J
f
a
a
a
a
M
G
"}
(14,1,1) = {"
U
G
a
a
a
a
a
f
Y
r
X
l
B
f
a
a
a
a
M
G
"}
(15,1,1) = {"
U
G
a
a
a
a
a
f
f
f
f
f
f
f
a
a
a
a
M
G
"}
(16,1,1) = {"
U
G
a
a
a
a
a
a
a
a
a
a
a
a
a
a
a
a
a
G
"}
(17,1,1) = {"
U
G
a
a
a
a
a
a
a
a
a
a
a
a
a
a
a
a
a
G
"}
(18,1,1) = {"
U
G
a
a
a
a
a
a
a
a
a
a
a
a
a
a
a
a
a
G
"}
(19,1,1) = {"
U
G
a
a
a
a
a
a
a
a
a
a
a
a
a
a
a
a
a
G
"}
(20,1,1) = {"
U
G
G
G
G
G
G
G
G
G
G
G
G
G
G
G
G
G
G
G
"}
